 2#########  
###       # 
#    $    # 
#   @ $   # 
#  .$     # 
#  .      #
# $ ..$ .  ##
#         #
########## 