3#########  
### @     # 
#   $     # 
#   ..$  # 
#         # 
#         #
#    .$   ##
#        #
#    .$    #
#  .$      #
#        #
########## 