 4#########  
###       # 
#.   $    # 
##  ## @  # 
#  .$   $  # 
#  #   .   #
# $ #$   ##
#  .    . ##
########## 